............................................
............................................
.............++++...........................
............................................
........++++................................
............................................
..@.++....................................%.
...............++......+++++++$........+++++
++++++..++++...++......+++++++.........+++++
++++++//++++///++//////+++++++/////////+++++