++............................................++++++++++++++++
++............................................++++++++++++++++
++............................................++++++++++++++++
++.@..........................................++++++++++++++++
++......................!..................%..++++++++++++++++
+++++++..............++++++..........+++++++++++++++++++++++++
+++++++..........................+...!........++++++++++++++++
+++++++.......+++++...........++++++++++++++++++++++++++++++++
+++++++...!...+++++$..........++++++++++++++++++++++++++++++++
+++++++++++++++++++///////////++++++++++++++++++++++++++++++++
+++++++++++++++++++...........++++++++++++++++++++++++++++++++