++............................................++++++++++++++++++++
++............................................++++++++++++++++++++
++............................................++++++++++++++++++++
++@...........................................++++++++++++++++++++
++++..........................................++++++++++++++++++++
++.............++++...........................++++++++++++++++++++
++............................................++++++++++++++++++++
++........++++................................++++++++++++++++++++
++............................................++++++++++++++++++++
++....++....................................%.++++++++++++++++++++
++...............++......+++++++$........+++++++++++++++++++++++++
++++++++..++++...++......+++++++.........+++++++++++++++++++++++++
++++++++..++++...++......+++++++.........+++++++++++++++++++++++++
++++++++..++++...++......+++++++.........+++++++++++++++++++++++++
++++++++..++++...++......+++++++.........+++++++++++++++++++++++++
++++++++//++++///++//////+++++++/////////+++++++++++++++++++++++++
