............................................
............................................
............................................
.@..........................................
......................&..................%..
+++++..............++++++..........+++++++++
+++++..........................+...&........
+++++.......+++++...........++++++++++++++++
+++++...&...+++++$..........++++++++++++++++
+++++++++++++++++///////////++++++++++++++++