++++++++++...............................................................++++++++++
++++++++++................................................!...........!..++++++++++
++++++++++.@.....................................+++++...+++++++....+++++++++++++++
++++++++++........+++...++++.................+++++.......................++++++++++
++++++++++++$..................+++++......!..............!........++++...++++++++++
++++++++++++...........................++++........++++++++++++..........++++++++++
++++++++++++..........!..................................................++++++++++
++++++++++++....!....+++................!.........................%......++++++++++
++++++++++++...+++...+++..++++.........++++++++++++....++++++++++++++++++++++++++++
++++++++++++...+++...+++..++++.........++++++++++++....++++++++++++++++++++++++++++
++++++++++++...+++...+++..++++.........++++++++++++....++++++++++++++++++++++++++++
++++++++++++...+++...+++..++++.........++++++++++++....++++++++++++++++++++++++++++
++++++++++++///+++///+++//++++/////////++++++++++++////++++++++++++++++++++++++++++