...............................................................
................................................!...........!..
.@.....................................+++++...+++++++....+++++
........+++...++++.................+++++.......................
++$..................+++++......!..............!........++++...
++...........................++++........++++++++++++..........
++..........!..................................................
++....!....+++................!.........................%......
++...+++...+++....!..........++++++++++++....++++++++++++++++++
++///+++///+++//++++/////////++++++++++++....++++++++++++++++++