@...........................................
++..........................................
.............++++...........................
............................................
........++++................................
............................................
....++....................................%.
...............++......+++++++$........+++++
++++++..++++...++......+++++++.........+++++
++++++//++++///++//////+++++++/////////+++++