............................................
............................................
............................................
.@..........................................
......................!..................%..
+++++..............++++++..........+++++++++
+++++..........................+...!........
+++++.......+++++...........++++++++++++++++
+++++...!...+++++$..........++++++++++++++++
+++++++++++++++++///////////++++++++++++++++