++++++++++++++++++++++++++++++++++++++++++++++++++++++++++++++++++++++++++++++
++...........................................+++++++++++++++++++++++++++++++++
+.................+++++++..+++++...............+++++++++++++++++++++++++++++++
+..@...........++++................+++++++.....+++++++++++++++++++++++++++++++
+++++++.++++++...............................%.+++++++++++++++++++++++++++++++
++++++....!................................+++++++++++++++++++++++++++++++++++
+++++++++++++...............................++++++++++++++++++++++++++++++++++
++++.....!................................!.++++++++++++++++++++++++++++++++++
+++++++++++++++++++++++++++++......+++++++++++++++++++++++++++++++++++++++++++
++++........................................++++++.........................+++
+..$.+.+++++...................................+.............................+
++++++......++.++++++........................................................+
+.....................+++....................................................+
+........&.................++..........+++++++++++++.........................+
+.....+++++++++..++++++.....++++++++++.........+..#..........................+
+..............................................+++++++.......................+
+..............................................+.............................+
+!!!!!!!!!!!!!!!!!!!!!!!!!!!!!!!!!!!!!!!!!!!!!!+.............................+
++++++++++++++++++++++++++++++++++++++++++++++++.............................+
++++++++++++++++++++++++++++++++++++++++++++++++....!......!......*.......!..+
++++++++++++++++++++++++++++++++++++++++++++++++++++++++++++++++++++++++++++++
