++++++++++++++++++++++++++++++++++++++++++++++++++++++++++++++++++++++++++++++++++++++++++++++++++
++++++++++++++++++++++++++++++++++++++++++++++++++++++++++++++++++++++++++++++++++++++++++++++++++
++++++++++++++++++++++++++++++++++++++++++++++++++++++++++++++++++++++++++++++++++++++++++++++++++
++++++++++++++++++++++++++++++++++++++++++++++++++++++++++++++++++++++++++++++++++++++++++++++++++
++++++++++++++++++++++++++++++++++++++++++++++++++++++++++++++++++++++++++++++++++++++++++++++++++
++++++++++++++++++++++++++++++++++++++++++++++++++++++++++++++++++++++++++++++++++++++++++++++++++
++++++++++++...........................................+++++++++++++++++++++++++++++++++++++++++++
+++++++++++.................+++++++..+++++...............+++++++++++++++++++++++++++++++++++++++++
+++++++++++..@...........++++................+++++++.....+++++++++++++++++++++++++++++++++++++++++
+++++++++++++++++.++++++...............................%.+++++++++++++++++++++++++++++++++++++++++
++++++++++++++++....!................................+++++++++++++++++++++++++++++++++++++++++++++
+++++++++++++++++++++++...............................++++++++++++++++++++++++++++++++++++++++++++
++++++++++++++.....!................................!.++++++++++++++++++++++++++++++++++++++++++++
+++++++++++++++++++++++++++++++++++++++......+++++++++++++++++++++++++++++++++++++++++++++++++++++
++++++++++++++........................................++++++.........................+++++++++++++
+++++++++++..$.+.+++++...................................+.............................+++++++++++
++++++++++++++++......++.++++++........................................................+++++++++++
+++++++++++.....................+++....................................................+++++++++++
+++++++++++........&.................++..........+++++++++++++.........................+++++++++++
+++++++++++.....+++++++++..++++++.....++++++++++.........+..#..........................+++++++++++
+++++++++++..............................................+++++++.......................+++++++++++
+++++++++++..............................................+.............................+++++++++++
+++++++++++!!!!!!!!!!!!!!!!!!!!!!!!!!!!!!!!!!!!!!!!!!!!!!+.............................+++++++++++
++++++++++++++++++++++++++++++++++++++++++++++++++++++++++.............................+++++++++++
++++++++++++++++++++++++++++++++++++++++++++++++++++++++++....!......!......*.......!..+++++++++++
++++++++++++++++++++++++++++++++++++++++++++++++++++++++++++++++++++++++++++++++++++++++++++++++++
++++++++++++++++++++++++++++++++++++++++++++++++++++++++++++++++++++++++++++++++++++++++++++++++++
++++++++++++++++++++++++++++++++++++++++++++++++++++++++++++++++++++++++++++++++++++++++++++++++++
++++++++++++++++++++++++++++++++++++++++++++++++++++++++++++++++++++++++++++++++++++++++++++++++++
++++++++++++++++++++++++++++++++++++++++++++++++++++++++++++++++++++++++++++++++++++++++++++++++++
++++++++++++++++++++++++++++++++++++++++++++++++++++++++++++++++++++++++++++++++++++++++++++++++++
++++++++++++++++++++++++++++++++++++++++++++++++++++++++++++++++++++++++++++++++++++++++++++++++++

